                            
1111111111111111
14418  4 4sssss1
1341  4   1 4741
1 41     914 4 1
134    131 4 411
134144441114 4 1
1 4     1     11
1 41     1     1
1641     4  1  1
1541    34  16 1
1111111111111111

